201,SINGLE,1,1,0,0,1,0
202,SINGLE,1,1,0,0,0,1
203,SINGLE,1,1,0,0,1,0
204,SINGLE,1,1,0,0,0,1
301,SINGLE,1,1,0,0,1,0
302,SINGLE,1,1,0,0,0,1
303,SINGLE,1,1,0,0,1,0
304,SINGLE,1,1,0,0,0,1
205,DOUBLE,0,1,0,0,1,0
206,DOUBLE,1,0,0,0,0,1
207,DOUBLE,0,1,0,0,1,0
208,DOUBLE,1,0,0,0,0,1
305,DOUBLE,0,1,0,0,1,0
306,DOUBLE,1,0,0,0,0,1
307,DOUBLE,0,1,0,0,1,0
308,DOUBLE,1,0,0,0,0,1
401,SUITE,1,1,1,1,0,1
402,SUITE,1,1,1,1,0,1
